E=4
S=0
D=0
11111111111111111111
10001111111111110001
10111111111111111101
10100111111111100101
11101111111111110111
11111011111111011111
11111111111111111111
11111111111111111111
11111111111111111111
11111111111111111111
11111111111111111111
11111111111111111111
11111111111111111111
11111111111111111111
11111111111111111111
11111111111111111111
11111111111111111111
11111111111111111111
11111111111111111111
11111111111111111111
11111111111111111111
11111111111111111111
11111111111111111111
11111111111111111111
11111011111111011111
11101111111111110111
10100111111111100101
10111111111111111101
10001111111111110001
11111111111111111111