E=4
S=0
D=0
0111111111
1000111111
1011111111
1111111111
1111111111
1111111111
1111111111
1111111101
1111110001
1111111110
